number,name,team_city,position,games,goals_official,assists,points,sog,shots_blocked,shots
13,Kaleigh Fratkin,Boston,D,7,0,9,9,11,9,20
13,Mikyla Grant-Mentis,Toronto,F,6,5,4,9,28,11,39
21,Christina Putigna,Boston,F,7,2,6,8,24,5,29
17,McKenna Brand,Boston,F,7,3,4,7,25,15,40
14,Jillian Dempsey,Boston,F,7,3,3,6,16,3,19
44,Lindsay Eastwood,Toronto,D,6,1,5,6,9,12,21
23,Nina Rodgers,Minnesota,F,4,2,4,6,9,1,10
8,Alyssa Wohlfeiler,Connecticut,F,4,1,4,5,13,3,16
42,Meghara McManus,Boston,F,7,2,3,5,20,3,23
19,Samantha Davis,Boston,F,7,4,1,5,17,3,20
2,Taylor Woods,Toronto,F,6,4,1,5,18,14,32
21,Amy Curlew,Toronto,F,6,0,4,4,3,2,5
21,Audra Richards,Minnesota,F,4,1,3,4,7,2,9
11,Breanne Wilson-Bennett,Toronto,F,6,2,2,4,23,4,27
19,Brooke Boquist,Toronto,F,4,2,2,4,18,8,26
15,Emma Vlasic,Connecticut,F,4,1,3,4,10,2,12
67,Emma Woods,Toronto,F,4,0,4,4,22,6,28
25,Kristin Lewicki,Buffalo,F,6,2,2,4,15,1,16
20,Meghan Lorence,Minnesota,F,4,0,4,4,11,3,14
9,Autumn MacDougall,Buffalo,F,6,3,0,3,15,4,19
19,Haley Mack,Minnesota,F,4,2,1,3,10,1,11
27,Jordan Juron,Buffalo,F,6,1,2,3,17,3,20
5,Leila Kilduff,Metropolitan,D,3,2,1,3,5,1,6
16,Lexie Laing,Boston,F,7,1,2,3,10,3,13
47,Mallory Souliotis,Boston,D,7,3,0,3,16,4,20
4,Marie-Jo Pelletier,Buffalo,D,6,0,3,3,5,3,8
24,Sarah-Eve Coutu Godbout,Toronto,F,6,2,1,3,28,9,37
27,Shiann Darkangelo,Toronto,F,6,0,3,3,23,5,28
6,Sydney Baldwin,Minnesota,D,4,1,2,3,14,12,26
8,Taylor Turnquist,Boston,D,7,0,3,3,10,13,23
17,Taytum Clairmont,Toronto,F,6,1,2,3,8,4,12
5,Tori Howran,Connecticut,D,3,1,2,3,5,3,8
23,Alyson Matteau,Buffalo,D,6,0,2,2,9,6,15
88,Amanda Conway,Connecticut,F,4,1,1,2,7,1,8
14,Elena Orlando,Connecticut,D,4,0,2,2,2,0,2
12,Emily Fluke,Toronto,F,6,1,1,2,3,3,6
23,Katelynn Russ,Connecticut,F,4,2,0,2,22,1,23
8,Kelly Babstock,Metropolitan,F,3,0,2,2,5,1,6
4,Lauren Kelly,Boston,D,7,2,0,2,13,12,25
9,Mackenzie MacNeil,Toronto,F,6,2,0,2,18,2,20
18,Rebecca Russo,Metropolitan,F,3,1,1,2,7,2,9
6,Sarah Steele,Toronto,D,6,0,2,2,5,4,9
6,Shannon Doyle,Connecticut,D,4,0,2,2,8,7,15
73,Tereza Vanisova,Boston,F,7,0,2,2,18,5,23
9,Tori Sullivan,Boston,F,7,0,2,2,4,2,6
16,Brooke Avery,Metropolitan,F,3,0,1,1,1,0,1
12,Brooke Stacey,Buffalo,F,6,0,1,1,12,3,15
10,Brooke White,Minnesota,F,4,1,0,1,1,0,1
13,Cailey Hutchison,Metropolitan,F,3,1,0,1,2,1,3
23,Carlee Turner,Boston,F,7,0,1,1,14,1,15
4,Emily Janiga,Metropolitan,F,3,1,0,1,4,1,5
25,Emma Greco,Toronto,D,6,0,1,1,6,4,10
7,Emma Stauber,Minnesota,D,4,0,1,1,3,4,7
91,Haylea Schmid,Minnesota,F,3,1,0,1,8,2,10
12,Jenna Rheault,Boston,D,3,0,1,1,0,1,1
3,Jonna Curtis,Minnesota,F,4,1,0,1,14,2,16
28,Kate Leary,Metropolitan,F,3,0,1,1,4,0,4
9,Kaycie Anderson,Connecticut,F,4,1,0,1,7,1,8
29,Kayla Friesen,Connecticut,F,3,1,0,1,16,4,20
21,Kayla Meneghin,Buffalo,F,3,0,1,1,3,0,3
10,Kendall Cornine,Metropolitan,F,3,0,1,1,6,2,8
26,Kiira Dosdall,Metropolitan,D,3,0,1,1,11,2,13
5,Lenka Curmova,Buffalo,D,6,0,1,1,4,3,7
11,Lisa Chesson,Buffalo,D,3,1,0,1,2,3,5
20,Mallory Rushton,Metropolitan,F,3,1,0,1,6,1,7
15,Meaghan Pezon,Minnesota,F,4,1,0,1,3,1,4
2,Meaghan Rickard,Boston,F,7,1,0,1,10,3,13
23,Megan Quinn,Toronto,D,6,1,0,1,9,3,12
22,Natalie Marcuzzi,Toronto,F,6,0,1,1,19,7,26
20,Paige Capistran,Boston,D,7,0,1,1,7,6,13
14,Rose Alleva,Minnesota,D,4,0,1,1,0,1,1
21,Sarah Schwenzfeier,Connecticut,F,4,0,1,1,4,2,6
71,Saroya Tinker,Metropolitan,D,3,0,1,1,2,3,5
18,Stephanie Anderson,Minnesota,F,4,0,1,1,12,4,16
18,Taylor Wenczkowski,Boston,F,7,1,0,1,21,6,27
3,Theresa Knutson,Metropolitan,F,3,1,0,1,10,4,14
77,Whitney Dove,Buffalo,D,6,0,1,1,8,5,13
5,Winny Brodt-Brown,Minnesota,D,4,1,0,1,1,0,1
10,Alexa Aramburu,Connecticut,F,0,0,0,0,0,0,0
22,Allie Olnowich,Metropolitan,D,3,0,0,0,4,1,5
9,Allie Thunstrom,Minnesota,F,4,0,0,0,11,2,13
8,Amanda Boulier,Minnesota,D,0,0,0,0,0,0,0
28,Briana Mastel,Boston,D,6,0,0,0,5,6,11
33,Bridgette Prentiss,Metropolitan,D,0,0,0,0,0,0,0
16,Brittany Colton,Buffalo,F/D,6,0,0,0,1,1,2
17,Cassidy MacPherson,Buffalo,F,6,0,0,0,18,2,20
4,Chelsey Brodt-Rosenthal,Minnesota,D,4,0,0,0,1,1,2
13,Dominique Kremer,Buffalo,D,6,0,0,0,5,1,6
7,Emma Ruggiero,Buffalo,F,0,0,0,0,0,0,0
81,Erin Gehen,Buffalo,F,6,0,0,0,12,4,16
94,Grace Klienbach,Connecticut,F,4,0,0,0,2,2,4
16,Hanna Beattie,Connecticut,D,4,0,0,0,4,0,4
98,Hunter Accursi,Buffalo,F,6,0,0,0,3,0,3
8,Iveta Klimasova,Buffalo,F,6,0,0,0,9,2,11
24,Janine Weber,Connecticut,F,4,0,0,0,13,2,15
24,Jayne Lewis,Metropolitan,F,3,0,0,0,0,1,1
91,Jenna McParland,Toronto,F,1,0,0,0,0,0,0
93,Julie Allen,Toronto,F,6,0,0,0,4,0,4
15,Kelly O'Sullivan,Buffalo,D,0,0,0,0,0,0,0
20,Kristen Barbara,Toronto,D,4,0,0,0,2,3,5
7,Mary Parker,Boston,F,4,0,0,0,7,1,8
35,Lovisa Selander,Boston,G,,,,,,,
33,Victoria Hanson,Boston,G,,,,,,,
3,Megan Delay,Buffalo,D,6,0,0,0,1,1,2
10,Neve Van Pelt,Buffalo,F,5,0,0,0,3,2,5
19,Taylor Wasylk,Buffalo,F,4,0,0,0,10,0,10
70,Carly Jackson,Buffalo,G,,,,,,,
1,Caty Flagg,Buffalo,G,,,,,,,
35,Abbie Ives,Connecticut,G,,,,,,,
1,Brooke Wolejko,Connecticut,G,,,,,,,
37,Mariah Fujimagri,Connecticut,G,,,,,,,
25,Maeve Reily,Connecticut,F,1,0,0,0,0,0,0
7,Rachael Ade,Connecticut,F,1,0,0,0,3,1,4
27,Sarah Hughson,Connecticut,F,1,0,0,0,1,0,1
10,Laurel Hill,Connecticut,D,2,0,0,0,1,1,2
13,Nicole Guagliardo,Connecticut,F,2,0,0,0,2,2,4
22,Mackenzie Lancaster,Connecticut,F,3,0,0,0,10,1,11
20,Maddie Bishop,Connecticut,F,4,0,0,0,1,1,2
12,Maggie LaGue,Connecticut,D,4,0,0,0,7,7,14
4,Taylor Marchin,Connecticut,D,4,0,0,0,4,2,6
29,Sonjia Shelly,Metropolitan,G,,,,,,,
31,Tera Hofmann,Metropolitan,G,,,,,,,
14,Madison Packer,Metropolitan,F,3,0,0,0,10,2,12
6,Paige Voight,Metropolitan,F,3,0,0,0,4,3,7
9,Rebecca Morse,Metropolitan,D,3,0,0,0,3,11,14
7,Sammy Kolowrat,Metropolitan,D,3,0,0,0,1,3,4
31,Allie Morse,Minnesota,G,,,,,,,
29,Amanda Leveille,Minnesota,G,,,,,,,
22,Lynn Astrup,Minnesota,F,4,0,0,0,0,1,1
33,Maddie Rowe,Minnesota,D,4,0,0,0,3,1,4
88,Sara Bustad,Minnesota,D,4,0,0,0,4,1,5
29,Elaine Chuli,Toronto,G,,,,,,,
34,Samantha Ridgewell,Toronto,G,,,,,,,